                                                                  
 #########       #############                                    
 #-------#       #-----------##                                   
 #-------#       #------------#               ##########          
 #-------#       ############-#               #--------#          
 #-------#                  #-#               #--------#          
 #-------#    ########   ####-#               #--------#          
 #-------#    #------#   #----#    ########   ####--####          
 #-------#    #------#   #----#    #------#      #--#             
 #-------#    #------#   #----#    #------#      #--#             
 #-------#    #------#   #----#    #------#      #--#             
 #-------#    #------#   #----#    #------#      #--#             
 #########    #------#####----#    #---####      #--#             
 #####-#      #----------#----#    #---#         #--#             
 #-----########------#####----#    #---#         #--#             
 #-------------------#   #----######---###########--########      
 ##############------#   #-----------------#---------------#      
              #------#   #----##############---------------#      
              #------#   #----#            #---------------#      
              #------#   ####-#            #---------------#      
              #------#      #-#            #---#############      
              ##-----#      #-#            #---#    #-#           
               #######  ###########        #---#    #-#           
    ######              #---------#        #---#    #-#           
    #----#              #---------#        #---#    #-#           
    #----################---------#        #####    #-#           
    #-----------#-----------------#                 #-#           
    #-----------#########---------#                 #-#####       
    #-----------#       ###########                 #-#---#       
    #-----------#                                   #-----#       
    #-----------#                                   #####-#       
    #-----------#                                       #-#       
    #-----------#             ###########    ######     #-#       
    #-----------#             #---------#    #----#     #-#       
    #-----------#             #---------#    #----#     #-#       
    #-----------############  #---------#    #----#     #-#       
    #-----------#----------####---------#    #----#     #-#       
    #################------#------------######----#######-#       
                    #------####---------#-----------------#       
                    #------#  #############################       
                    #------#                                      
                    #------#                                      
                    #------#                                      
                    ########                                      
                                                                  
