                                                                  
                                                                  
                                                           ###### 
                                                           #----# 
                              #########                    #----# 
                              #-------#           ######## #----#
                              #-------#           #------###----#
    #######             #######-#######           #------###----#
    #-----##            #-------#                 #------###----#
    ##-----##           #-------#                 ######## #----#
     ##-----###         #-------#                          #-#--# 
      ##------##        #-------#                          #-#--# 
       ###-----##       #-------#                          #-#--#
         ##-----#########-------#                          #-#--# 
          ##--------------------#                          #-#--# 
           ##-----###############                          #-##-# 
            ##-----##                                      #--#-# 
             #########                                     #--#-# 
              ##-----##                 ############       #--#-# 
     ############-----##                #----------#       #--### 
     #----------#------##               #----------#       #----# 
     ######-----##------###             #-##########       #----# 
          #------####-----##            #----------#       #----# 
         ##--------###-----##           #----------#       #----# 
         #------------------##          ##########-#       #----# 
         #--------#####------##         #----------#       #-#### 
         #--------#   ##########        #----------#       #----# 
         #--------#     ##-----##       #----------#       ####-# 
         #----###-#      ##-----##      #----------#       #----# 
         #----# #-#       ##-----##    ##----------#       #----# 
         #----# #-#        ##-----######-----------#       #----# 
         #----# #-#         ##---------------------#       #----# 
         #----# ###          ##------###############       #----# 
         ######               ##------##                   #----# 
                               ##------##                  #----# 
                                ##------##                 #----# 
                                 ##########                #----# 
                                 ##-------##               #----# 
                                  ##-------##              #----# 
                                   ##-------################----# 
                                    ##---------#----------------# 
                                     ##--------#---#-----#------# 
                                      ###----------#-----#------# 
                                        ######################### 
                                                                  
